111111111111111111111111111111111111111111
1P0000000000000000000000000000000000000001
100000000000000000000000000000000000000001
10000000C000C00000CCCC00000000011101110001
10000000C000C00000C00CC0000000010010010001
10000000C000C0000000CC00000000010000010001
10000000CCCCC000000CC000000000001000100001
10000000000CC00000CC0000000000000101000001
10000000000CC0000CCCCCC0000000000010000001
100000000000000000000000000000000000000001
1000000000000000000000000000000000000000E1
111111111111111111111111111111111111111111